//MAP CONVERTED BY dmm2tgm.py THIS HEADER COMMENT PREVENTS RECONVERSION, DO NOT REMOVE
"aa" = (
/obj/structure/machinery/cm_vending/sorted/medical{
	density = 0;
	pixel_y = 18
	},
/obj/structure/machinery/light/double/blue/golden_arrow{
	dir = 8;
	light_power = 0.7
	},
/turf/open/floor/almayer/dark_sterile,
/area/golden_arrow/medical)
"ab" = (
/obj/structure/machinery/cm_vending/gear/medic_chemical{
	density = 0;
	pixel_y = 20
	},
/turf/open/floor/almayer/dark_sterile,
/area/golden_arrow/medical)
"ac" = (
/obj/structure/surface/table/reinforced/prison,
/obj/item/clothing/accessory/stethoscope,
/obj/item/device/flashlight/pen{
	pixel_x = -5;
	pixel_y = 6
	},
/obj/effect/decal/warning_stripes{
	icon_state = "E";
	pixel_x = 1
	},
/turf/open/floor/almayer/sterile_green_side/east,
/area/golden_arrow/medical)
"ad" = (
/obj/structure/closet/crate/freezer{
	name = "blood cooler crate";
	pixel_y = 7
	},
/obj/item/reagent_container/blood/OMinus,
/obj/item/reagent_container/blood/OMinus{
	pixel_x = -5
	},
/obj/item/reagent_container/blood/OMinus{
	pixel_x = 7
	},
/obj/item/reagent_container/blood/OMinus,
/turf/open/floor/almayer/dark_sterile,
/area/golden_arrow/medical)
"ae" = (
/obj/structure/pipes/vents/scrubber,
/turf/open/floor/almayer/dark_sterile,
/area/golden_arrow/medical)
"af" = (
/turf/open/floor/almayer/dark_sterile,
/area/golden_arrow/medical)
"ag" = (
/obj/structure/surface/table/reinforced/prison,
/obj/item/reagent_container/hypospray/autoinjector/adrenaline_concentrated{
	pixel_x = 5;
	pixel_y = 10
	},
/obj/item/reagent_container/hypospray/autoinjector/adrenaline_concentrated{
	pixel_x = -5;
	pixel_y = 13
	},
/obj/item/storage/belt/medical/only_scanner,
/obj/item/storage/belt/medical/lifesaver/standard/full,
/obj/item/storage/belt/medical/lifesaver/standard/full,
/obj/effect/decal/warning_stripes{
	icon_state = "E";
	pixel_x = 1
	},
/turf/open/floor/almayer/sterile_green_side/east,
/area/golden_arrow/medical)
"ah" = (
/obj/structure/closet/crate/secure/surgery,
/obj/item/pamphlet/skill/surgery,
/turf/open/floor/almayer/dark_sterile,
/area/golden_arrow/medical)
"ai" = (
/obj/structure/surface/table/reinforced/prison,
/obj/item/storage/firstaid/softpack{
	pixel_x = 5;
	pixel_y = 11
	},
/obj/item/storage/firstaid/softpack/brute,
/obj/item/storage/firstaid/softpack/burn{
	layer = 3.01;
	pixel_x = -9;
	pixel_y = 9
	},
/obj/item/storage/firstaid/softpack{
	pixel_x = -11;
	pixel_y = -5
	},
/obj/structure/closet/secure_closet/surgical{
	pixel_x = 30
	},
/obj/effect/decal/warning_stripes{
	icon_state = "E";
	pixel_x = 1
	},
/turf/open/floor/almayer/sterile_green_side/east,
/area/golden_arrow/medical)
"aj" = (
/obj/structure/surface/table/reinforced/prison,
/obj/item/storage/surgical_case/regular{
	pixel_y = 13
	},
/obj/item/roller{
	pixel_y = 6
	},
/obj/effect/decal/warning_stripes{
	icon_state = "E";
	pixel_x = 1
	},
/turf/open/floor/almayer/sterile_green_side/east,
/area/golden_arrow/medical)
"ak" = (
/obj/structure/surface/table/reinforced/prison,
/obj/structure/machinery/light/double/blue{
	dir = 8;
	light_color = "#dae2ff"
	},
/obj/structure/machinery/computer/med_data/laptop{
	dir = 4;
	pixel_x = 1;
	pixel_y = 3
	},
/turf/open/floor/almayer/dark_sterile,
/area/golden_arrow/medical)
"al" = (
/obj/structure/machinery/chem_dispenser/medbay{
	pixel_x = -4
	},
/obj/structure/machinery/light/double/blue/golden_arrow,
/obj/effect/decal/warning_stripes{
	icon_state = "S"
	},
/turf/open/floor/almayer/sterile_green_side,
/area/golden_arrow/medical)
"am" = (
/obj/structure/machinery/chem_master{
	pixel_x = -11
	},
/obj/effect/decal/warning_stripes{
	icon_state = "S"
	},
/obj/structure/closet{
	pixel_x = 10;
	pixel_y = -2
	},
/obj/item/stack/sheet/mineral/phoron,
/obj/item/stack/sheet/mineral/phoron,
/obj/item/stack/sheet/mineral/phoron,
/obj/item/stack/sheet/mineral/phoron,
/obj/item/stack/sheet/mineral/phoron,
/obj/item/stack/sheet/mineral/phoron,
/obj/item/stack/sheet/mineral/phoron,
/obj/item/stack/sheet/mineral/phoron,
/obj/item/stack/sheet/mineral/phoron,
/obj/item/stack/sheet/mineral/phoron,
/obj/item/reagent_container/glass/beaker/bluespace,
/obj/item/reagent_container/glass/beaker/bluespace,
/obj/item/reagent_container/glass/beaker/bluespace,
/obj/item/reagent_container/glass/beaker/bluespace,
/obj/item/reagent_container/glass/beaker/bluespace,
/obj/item/reagent_container/glass/beaker/bluespace,
/obj/item/reagent_container/glass/beaker/bluespace,
/obj/item/reagent_container/glass/beaker/bluespace,
/obj/item/storage/box/autoinjectors,
/obj/item/storage/box/autoinjectors,
/obj/item/storage/box/pillbottles,
/obj/item/storage/box/beakers,
/obj/item/storage/box/beakers,
/turf/open/floor/almayer/sterile_green_side,
/area/golden_arrow/medical)
"an" = (
/obj/structure/machinery/juicer,
/obj/structure/surface/table/almayer,
/obj/effect/decal/warning_stripes{
	icon_state = "S"
	},
/turf/open/floor/almayer/sterile_green_side,
/area/golden_arrow/medical)
"ao" = (
/obj/structure/machinery/smartfridge,
/obj/structure/machinery/light/double/blue/golden_arrow,
/obj/effect/decal/warning_stripes{
	icon_state = "E";
	pixel_x = 1
	},
/obj/effect/decal/warning_stripes{
	icon_state = "S"
	},
/turf/open/floor/almayer/sterile_green_corner/east,
/area/golden_arrow/medical)
"ap" = (
/turf/template_noop,
/area/template_noop)
"aq" = (
/obj/effect/decal/warning_stripes{
	icon_state = "door_warning";
	dir = 1
	},
/obj/structure/machinery/cm_vending/sorted/medical/blood{
	req_access = list();
	req_one_access_txt = "8;12"
	},
/turf/open/floor/almayer/plate,
/area/golden_arrow/medical)
"ar" = (
/obj/effect/decal/warning_stripes{
	icon_state = "SW-out";
	pixel_x = -1
	},
/obj/structure/phone_base{
	name = "medical bay receiver";
	dir = 8;
	pixel_x = 23;
	pixel_y = 6;
	phone_category = "Golden Arrow";
	phone_id = "Medical Bay"
	},
/obj/structure/sign/safety/commline_connection{
	name = "communication line semiotic";
	pixel_x = 32;
	pixel_y = 22
	},
/obj/effect/decal/cleanable/blood/drip{
	pixel_x = -10;
	pixel_y = 9
	},
/obj/effect/decal/cleanable/blood/drip{
	pixel_x = 2;
	pixel_y = 16
	},
/obj/effect/decal/cleanable/blood/drip{
	pixel_x = -12;
	pixel_y = 19
	},
/turf/open/floor/almayer/plate,
/area/golden_arrow/medical)
"br" = (
/obj/effect/decal/warning_stripes{
	icon_state = "S"
	},
/obj/effect/decal/cleanable/blood,
/turf/open/floor/almayer/plate,
/area/golden_arrow/medical)
"eY" = (
/obj/structure/machinery/medical_pod/autodoc{
	pixel_y = 6
	},
/obj/effect/decal/cleanable/dirt{
	layer = 2.52
	},
/obj/effect/decal/cleanable/dirt{
	layer = 2.52
	},
/turf/open/floor/almayer/test_floor4,
/area/golden_arrow/medical)
"fy" = (
/obj/structure/pipes/standard/simple/hidden/supply{
	dir = 8
	},
/obj/structure/cable{
	icon_state = "1-4"
	},
/obj/effect/decal/warning_stripes{
	icon_state = "door_warning";
	dir = 4
	},
/obj/effect/decal/cleanable/blood,
/turf/open/floor/almayer/dark_sterile,
/area/golden_arrow/medical)
"gq" = (
/obj/effect/decal/warning_stripes{
	icon_state = "door_warning";
	dir = 1
	},
/turf/open/floor/almayer/plate,
/area/golden_arrow/medical)
"hc" = (
/obj/structure/machinery/camera/autoname/golden_arrow{
	dir = 8
	},
/turf/open/floor/almayer/dark_sterile,
/area/golden_arrow/medical)
"ij" = (
/obj/effect/decal/warning_stripes{
	icon_state = "door_warning"
	},
/obj/effect/decal/warning_stripes{
	icon_state = "door_warning";
	dir = 1
	},
/obj/item/prop/colony/usedbandage{
	dir = 4;
	pixel_x = -1;
	pixel_y = -7
	},
/turf/open/floor/almayer/plate,
/area/golden_arrow/medical)
"iC" = (
/obj/structure/machinery/autodoc_console{
	pixel_y = 6
	},
/obj/effect/decal/warning_stripes{
	icon_state = "W";
	layer = 3.3;
	pixel_x = -1
	},
/obj/effect/decal/cleanable/dirt{
	layer = 2.52
	},
/obj/structure/sign/safety/autodoc{
	pixel_x = 32
	},
/obj/effect/decal/cleanable/blood/drip,
/turf/open/floor/almayer/plate,
/area/golden_arrow/medical)
"jC" = (
/obj/structure/extinguisher_cabinet/alt{
	pixel_x = 11;
	pixel_y = 29
	},
/obj/effect/decal/warning_stripes{
	icon_state = "E";
	pixel_x = 1
	},
/obj/item/trash/used_stasis_bag,
/turf/open/floor/almayer/sterile_green_side/east,
/area/golden_arrow/medical)
"mo" = (
/obj/effect/decal/warning_stripes{
	icon_state = "SE-out";
	pixel_x = 1
	},
/turf/open/floor/almayer/plate,
/area/golden_arrow/medical)
"np" = (
/obj/structure/pipes/standard/simple/hidden/supply{
	dir = 8
	},
/obj/structure/cable{
	icon_state = "4-8"
	},
/obj/effect/decal/warning_stripes{
	icon_state = "door_warning";
	dir = 8
	},
/turf/open/floor/almayer/dark_sterile,
/area/golden_arrow/medical)
"oE" = (
/obj/structure/pipes/standard/manifold/hidden/supply,
/obj/structure/cable{
	icon_state = "1-8"
	},
/turf/open/floor/almayer/dark_sterile,
/area/golden_arrow/medical)
"oH" = (
/obj/structure/machinery/body_scanconsole{
	dir = 8;
	pixel_y = 6
	},
/obj/effect/decal/cleanable/dirt{
	layer = 2.52
	},
/obj/effect/decal/cleanable/blood,
/turf/open/floor/almayer/test_floor4,
/area/golden_arrow/medical)
"qE" = (
/obj/effect/decal/warning_stripes{
	icon_state = "door_warning";
	dir = 1
	},
/obj/effect/decal/cleanable/blood/drip{
	pixel_x = -12;
	pixel_y = 19
	},
/turf/open/floor/almayer/dark_sterile,
/area/golden_arrow/medical)
"qG" = (
/obj/effect/decal/warning_stripes{
	icon_state = "SE-out";
	pixel_x = 1
	},
/obj/structure/machinery/door/firedoor/border_only/almayer{
	dir = 2
	},
/obj/effect/decal/cleanable/dirt{
	layer = 2.52
	},
/turf/open/floor/almayer/test_floor4,
/area/golden_arrow/medical)
"rL" = (
/obj/structure/closet/crate/trashcart{
	pixel_y = 11
	},
/obj/item/prop/colony/usedbandage,
/obj/item/prop/colony/usedbandage{
	dir = 4
	},
/obj/item/prop/colony/usedbandage{
	dir = 6;
	pixel_y = 6
	},
/obj/item/prop/colony/usedbandage{
	dir = 10;
	pixel_y = 13
	},
/obj/item/storage/pill_bottle,
/obj/effect/decal/cleanable/dirt{
	layer = 2.52
	},
/obj/structure/machinery/light/small/blue{
	dir = 8;
	pixel_y = 10;
	light_power = 0.5;
	light_color = "#dae2ff"
	},
/turf/open/floor/almayer/dark_sterile,
/area/golden_arrow/medical)
"si" = (
/obj/effect/decal/warning_stripes{
	icon_state = "door_warning"
	},
/obj/structure/pipes/standard/simple/hidden/supply,
/turf/open/floor/almayer/dark_sterile,
/area/golden_arrow/medical)
"tD" = (
/obj/structure/machinery/light/double/blue{
	dir = 8;
	light_color = "#dae2ff"
	},
/obj/effect/decal/warning_stripes{
	icon_state = "S"
	},
/turf/open/floor/almayer/sterile_green_side,
/area/golden_arrow/medical)
"uq" = (
/obj/structure/machinery/light/double/blue{
	dir = 4;
	light_color = "#dae2ff"
	},
/obj/structure/machinery/medical_pod/bodyscanner{
	pixel_y = 6
	},
/obj/effect/decal/cleanable/dirt{
	layer = 2.52
	},
/turf/open/floor/almayer/test_floor4,
/area/golden_arrow/medical)
"uK" = (
/obj/structure/machinery/door/airlock/almayer/medical/glass{
	dir = 1
	},
/obj/structure/pipes/standard/simple/hidden/supply,
/turf/open/floor/almayer/dark_sterile,
/area/golden_arrow/medical)
"vK" = (
/obj/item/trash/used_stasis_bag,
/turf/open/floor/almayer/dark_sterile,
/area/golden_arrow/medical)
"vP" = (
/obj/effect/decal/warning_stripes{
	icon_state = "S"
	},
/obj/effect/decal/warning_stripes{
	icon_state = "E";
	pixel_x = 1
	},
/obj/effect/decal/cleanable/blood/gibs/down,
/turf/open/floor/almayer/sterile_green_corner/east,
/area/golden_arrow/medical)
"vX" = (
/obj/structure/machinery/cm_vending/clothing/medic{
	density = 0;
	pixel_y = 20
	},
/turf/open/floor/almayer/dark_sterile,
/area/golden_arrow/medical)
"xo" = (
/obj/structure/pipes/vents/pump{
	dir = 1
	},
/obj/effect/decal/warning_stripes{
	icon_state = "E";
	pixel_x = 1
	},
/obj/structure/bed/roller,
/obj/effect/decal/cleanable/blood,
/obj/item/prop/colony/usedbandage{
	dir = 10;
	pixel_x = -12;
	pixel_y = 15
	},
/obj/item/prop/colony/usedbandage{
	dir = 10;
	pixel_x = 9;
	pixel_y = 7
	},
/turf/open/floor/almayer/sterile_green_side/east,
/area/golden_arrow/medical)
"xp" = (
/obj/structure/machinery/medical_pod/autodoc{
	dir = 1;
	pixel_y = 6
	},
/obj/effect/decal/cleanable/dirt{
	layer = 2.52
	},
/turf/open/floor/almayer/test_floor4,
/area/golden_arrow/medical)
"zr" = (
/obj/structure/machinery/medical_pod/sleeper{
	pixel_y = 6
	},
/obj/effect/decal/cleanable/dirt{
	layer = 2.52
	},
/turf/open/floor/almayer/test_floor4,
/area/golden_arrow/medical)
"zu" = (
/obj/effect/decal/warning_stripes{
	icon_state = "door_warning";
	dir = 1
	},
/obj/structure/pipes/standard/simple/hidden/supply,
/turf/open/floor/almayer/dark_sterile,
/area/golden_arrow/medical)
"BR" = (
/obj/structure/machinery/door/airlock/almayer/medical{
	name = "\improper Medical Office";
	dir = 8;
	req_one_access = list();
	req_one_access_txt = "8;12"
	},
/obj/structure/pipes/standard/simple/hidden/supply{
	dir = 8
	},
/obj/structure/cable{
	icon_state = "4-8"
	},
/obj/effect/decal/cleanable/dirt{
	layer = 2.52
	},
/turf/open/floor/almayer/dark_sterile,
/area/golden_arrow/medical)
"Cj" = (
/obj/effect/decal/warning_stripes{
	icon_state = "S"
	},
/turf/open/floor/almayer/sterile_green_side,
/area/golden_arrow/medical)
"CI" = (
/obj/structure/machinery/power/apc/almayer/east,
/obj/structure/cable{
	icon_state = "0-2"
	},
/turf/open/floor/almayer/dark_sterile,
/area/golden_arrow/medical)
"CT" = (
/obj/structure/sign/safety/med_life_support{
	pixel_x = 33
	},
/obj/effect/decal/warning_stripes{
	icon_state = "door_warning"
	},
/obj/effect/decal/warning_stripes{
	icon_state = "door_warning";
	dir = 1
	},
/turf/open/floor/almayer/plate,
/area/golden_arrow/medical)
"Dj" = (
/obj/structure/machinery/autodoc_console{
	dir = 1;
	pixel_y = 6
	},
/obj/effect/decal/warning_stripes{
	icon_state = "E";
	pixel_x = 1
	},
/obj/structure/sign/safety/autodoc{
	pixel_x = -17
	},
/turf/open/floor/almayer/plate,
/area/golden_arrow/medical)
"DF" = (
/obj/effect/decal/strata_decals/grime/grime1{
	dir = 8
	},
/obj/structure/machinery/camera/autoname/golden_arrow,
/obj/effect/decal/warning_stripes{
	icon_state = "door_warning"
	},
/turf/open/floor/almayer/plate,
/area/golden_arrow/medical)
"Fe" = (
/obj/structure/surface/table/reinforced/prison,
/obj/item/paper_bin/uscm{
	pixel_x = -6;
	pixel_y = 7
	},
/obj/item/tool/pen{
	pixel_x = -7;
	pixel_y = 4
	},
/obj/effect/decal/cleanable/dirt{
	layer = 2.52
	},
/turf/open/floor/almayer/dark_sterile,
/area/golden_arrow/medical)
"Fh" = (
/turf/closed/wall/almayer,
/area/golden_arrow/medical)
"GG" = (
/obj/structure/pipes/standard/simple/hidden/supply{
	dir = 8
	},
/obj/structure/cable{
	icon_state = "4-8"
	},
/obj/effect/decal/cleanable/dirt{
	layer = 2.52
	},
/turf/open/floor/almayer/dark_sterile,
/area/golden_arrow/medical)
"HE" = (
/obj/structure/bed/chair/office/light{
	dir = 8;
	pixel_y = 5;
	buckling_y = 5
	},
/obj/structure/pipes/standard/simple/hidden/supply{
	dir = 6
	},
/turf/open/floor/almayer/dark_sterile,
/area/golden_arrow/medical)
"Ig" = (
/obj/structure/pipes/standard/simple/hidden/supply{
	dir = 8
	},
/obj/effect/decal/cleanable/blood/drip{
	pixel_x = 2;
	pixel_y = 16
	},
/turf/open/floor/almayer/dark_sterile,
/area/golden_arrow/medical)
"II" = (
/obj/structure/surface/table/reinforced/prison,
/obj/effect/decal/cleanable/dirt{
	layer = 2.52
	},
/obj/item/storage/surgical_tray/empty{
	pixel_y = 4
	},
/turf/open/floor/almayer/dark_sterile,
/area/golden_arrow/medical)
"Ll" = (
/obj/effect/decal/warning_stripes{
	icon_state = "E";
	pixel_x = 1
	},
/obj/structure/bed/roller,
/obj/effect/decal/cleanable/blood,
/obj/item/prop/colony/usedbandage{
	dir = 10;
	pixel_x = -11;
	pixel_y = 13
	},
/turf/open/floor/almayer/sterile_green_side/east,
/area/golden_arrow/medical)
"LE" = (
/obj/structure/surface/table/reinforced/prison,
/obj/structure/machinery/recharger{
	pixel_y = 3
	},
/obj/effect/decal/cleanable/dirt{
	layer = 2.52
	},
/obj/item/prop/colony/usedbandage,
/obj/item/tool/surgery/surgical_line{
	pixel_y = -14
	},
/turf/open/floor/almayer/dark_sterile,
/area/golden_arrow/medical)
"LQ" = (
/obj/structure/machinery/door/airlock/multi_tile/almayer/medidoor{
	name = "\improper Emergency Infirmary";
	req_one_access = null
	},
/obj/structure/pipes/standard/simple/hidden/supply,
/obj/structure/machinery/door/firedoor/border_only/almayer{
	dir = 2
	},
/obj/effect/decal/cleanable/dirt{
	layer = 2.52
	},
/turf/open/floor/almayer/test_floor4,
/area/golden_arrow/medical)
"MR" = (
/obj/effect/decal/cleanable/blood/gibs/core,
/turf/open/floor/almayer/dark_sterile,
/area/golden_arrow/medical)
"MS" = (
/obj/structure/machinery/sleep_console{
	dir = 8;
	pixel_y = 6
	},
/obj/effect/decal/cleanable/dirt{
	layer = 2.52
	},
/obj/item/prop/colony/usedbandage{
	dir = 10;
	pixel_x = -7;
	pixel_y = 6
	},
/turf/open/floor/almayer/test_floor4,
/area/golden_arrow/medical)
"OV" = (
/obj/structure/window/framed/almayer,
/turf/open/floor/plating,
/area/golden_arrow/medical)
"Pm" = (
/obj/structure/filingcabinet/medical{
	name = "medical records";
	density = 0;
	pixel_x = -8;
	pixel_y = 17
	},
/obj/structure/filingcabinet{
	density = 0;
	pixel_x = 8;
	pixel_y = 17
	},
/obj/effect/decal/cleanable/dirt{
	layer = 2.52
	},
/turf/open/floor/almayer/dark_sterile,
/area/golden_arrow/medical)
"PK" = (
/obj/effect/decal/warning_stripes{
	icon_state = "S"
	},
/obj/structure/bed/roller,
/turf/open/floor/almayer/plate,
/area/golden_arrow/medical)
"Qq" = (
/obj/structure/surface/table/reinforced/prison,
/obj/item/roller{
	pixel_y = 17
	},
/obj/item/roller{
	pixel_y = 23
	},
/obj/item/storage/firstaid/regular{
	pixel_x = -2;
	pixel_y = 1
	},
/turf/open/floor/almayer/dark_sterile,
/area/golden_arrow/medical)
"Qt" = (
/obj/effect/decal/warning_stripes{
	icon_state = "E";
	pixel_x = 1
	},
/obj/structure/pipes/standard/simple/hidden/supply{
	dir = 10
	},
/obj/effect/decal/cleanable/blood/gibs,
/turf/open/floor/almayer/sterile_green_side/east,
/area/golden_arrow/medical)
"QS" = (
/obj/structure/surface/table/reinforced/prison,
/obj/item/reagent_container/food/drinks/coffee/marine{
	pixel_x = -4;
	pixel_y = 14
	},
/obj/item/ashtray/plastic{
	pixel_x = -10;
	pixel_y = 3
	},
/obj/effect/decal/cleanable/dirt{
	layer = 2.52
	},
/turf/open/floor/almayer/dark_sterile,
/area/golden_arrow/medical)
"Sa" = (
/obj/effect/decal/warning_stripes{
	icon_state = "S"
	},
/turf/open/floor/almayer/plate,
/area/golden_arrow/medical)
"Vp" = (
/obj/structure/pipes/standard/simple/hidden/supply,
/obj/structure/cable{
	icon_state = "1-2"
	},
/obj/effect/decal/warning_stripes{
	icon_state = "door_warning";
	dir = 1
	},
/obj/effect/decal/cleanable/blood,
/turf/open/floor/almayer/dark_sterile,
/area/golden_arrow/medical)
"WU" = (
/obj/item/device/radio/intercom{
	name = "General Listening Channel";
	pixel_y = 29;
	freerange = 1
	},
/obj/effect/decal/warning_stripes{
	icon_state = "door_warning"
	},
/turf/open/floor/almayer/plate,
/area/golden_arrow/medical)
"Xv" = (
/obj/structure/surface/table/reinforced/prison,
/obj/item/storage/box/bodybags{
	pixel_x = -5;
	pixel_y = 11
	},
/obj/item/storage/box/bodybags{
	pixel_x = -2;
	pixel_y = 3
	},
/obj/effect/decal/cleanable/dirt{
	layer = 2.52
	},
/turf/open/floor/almayer/dark_sterile,
/area/golden_arrow/medical)
"XX" = (
/obj/structure/machinery/iv_drip{
	pixel_y = 6
	},
/obj/effect/decal/warning_stripes{
	icon_state = "S"
	},
/turf/open/floor/almayer/sterile_green_side,
/area/golden_arrow/medical)
"Yn" = (
/obj/effect/decal/cleanable/blood,
/turf/open/floor/almayer/dark_sterile,
/area/golden_arrow/medical)

(1,1,1) = {"
OV
QS
ak
Pm
Fh
aa
ad
ah
af
al
Fh
"}
(2,1,1) = {"
OV
Fe
HE
si
uK
zu
ae
af
af
am
Fh
"}
(3,1,1) = {"
OV
CI
fy
hc
Fh
vX
af
af
af
an
Fh
"}
(4,1,1) = {"
Fh
Fh
BR
Fh
Fh
ab
af
af
af
Cj
Fh
"}
(5,1,1) = {"
OV
Xv
np
rL
Fh
ac
ag
ai
aj
ao
Fh
"}
(6,1,1) = {"
OV
Qq
GG
MR
Fh
Fh
OV
Fh
Fh
Fh
Fh
"}
(7,1,1) = {"
LQ
Vp
oE
Yn
vK
tD
mo
Dj
Fh
ap
ap
"}
(8,1,1) = {"
qG
qE
Ig
LE
II
XX
Sa
eY
Fh
ap
ap
"}
(9,1,1) = {"
Fh
jC
Qt
xo
Ll
vP
PK
Fh
Fh
ap
ap
"}
(10,1,1) = {"
Fh
WU
oH
ij
MS
gq
br
xp
Fh
ap
ap
"}
(11,1,1) = {"
Fh
DF
uq
CT
zr
aq
ar
iC
Fh
ap
ap
"}
